_R____RRR_____S_____S_R________S________________RTTTTT_______RTTTTTTR*
_R_________S_____________S________S__________S__R____________R______R*
_R___S_________R______S___________S______S_S____R_____RRRRR__R______R*
_R____S________RJ_______________RRRRRRRRRRRRRRRRR_________R__R______R*
_R_____S_______R________________R______R____R___R_________R_________R*
_R_______S_____RRRRRRRRRRR______R______R____R___RQQRRRR___RRRR______R*
_R________S____RRTRTRTRTRR___RRRR__R___RRRRRR___R__R______R_IR______R*
_R_________S___RT_T_T_T_TRR____Q___R___R____R___Q__R__RRRRR__R______R*
_R______SR_______________R_________R___R____R_____RR__R___R__R______R*
_R_____S_R__________Q____RRRRRRRRRRR___RQQQQR_____R___R___R__R______R*
_RRRRRRRRRRRRRRR_________R__________S_______R_____R_______R__R______R*
_R___Q_________R_S_______R___RRRRRRRRRRRRRRRR__________RRRR__R______R*
_R_____________R_________R____J_____________RRRRRRRRR__R_____R______R*
_R_____________R_____S___RRR____R____R______R_______R__R__R__R______R*
_R_____________R_________R______R____J______RRRRRR_RR__R__R__R______R*
_R_____________R_________RRRRRRRRRRRRRR__J__________R__R__R__R______R*
_R_____________R___S_____R____________R_________R______R__RI________R*
_R______Q__Q_____________R____P_______RRRRRRRRRRRRRRRRRR__RRRRRRRRRRR*
_R___Q__Q_RQ_Q___________R____________R_____________________________R*
_R_Q____Q_Q_QQ_Q_________R____________R_____________________________R*
_R_Q__QQQQ____R__________R____________R_____________________________R*
_R_______________________R_S__________R_____________________________R*
_R_______________________R___S________R_____________________________R*
_R___RRRRRRRRRRRRRRRRRRRRR__S_______S_R_____________________________R*
_R____________________________________R_____________________________R*
_R____________________________________R_____________________________R*
_RRRRRRRRRRRRRRRRRRRRRRRRRRRRRRRRRRRRRR_____________________________R