_RRRRRRRRRRRRRRRRRRRRRRRRRRRRRRRRRRRRRRRRRRRRRRRRRRRRRRRRRRRRRRRRRRRR*
_R____RRR_____S_____S_R________S________________RTTTTTRRRRRRRRTTTTTTR*
_R_________S_____________S________S__________S__R____________R______R*
_R___S_________R______S___________S______S_S____R_____RRRRR__R______R*
_R____S________R________________RRRRRRRRRRRRRRRRR_________R__R______R*
_R_____S_______R________________R______R____R___R_________R_________R*
_R_______S_____RRRRRRRRRRR______R______R____R____QQRRRR___RRRR______R*
_R________S____RRTRTRTRTRR___RRRR__R___RRRRRR___R__R______R_IR______R*
_R_________S___RT_T_T_T_TRR____Q___R___R____R___Q__R__RRRRR__R______R*
_R______SR_______________R__J______R___R____R_____RR__R___R__R______R*
_R_____S_R__________Q____RRRRRRRRRRR___RQQQQR_____R___R___R__R______R*
_RRRRRRRRRRRRRRR_________R__________Þ_______R_____R_______R__R______R*
_R___Q_________R_S_______R___RRRRRRRRRRRRRRRR__________RRRR__R______R*
_R_____________R_________R____J_____________RRRRRRRRR__R_____R______R*
_R_____P_______R_____S___RRR____R____R______R_______R__R__R__R______R*
_R_____________R_________R______R____J______RRRRRR_RR__R__R__R______R*
_R_____________R_________RRRRRRRRRRRRRR__J__________R__R__R__R______R*
_R_____________R___S_____R____________R_________R______R__RI________R*
_R______Q__Q___R_________R_____Q______RRRRRRRRRRRRRRRRRR__RRRRRRRRRRR*
_R___Q__Q_RQ_Q_R_________R___Q__Q_____R_____________________________R*
_R_Q____Q_Q_QQ_R_________R__Q_Q__Q____R_____________________________R*
_R_Q__QQQQ____RR_________R__QQ___R____R_____________________________R*
_R____S________R___________Q___QQQ____R_____________________________R*
_R_____________R______________________R_____________________________R*
_R___RRRRRRRRRRRRRRRRRRRRR____________R_____________________________R*
_RS___________________________________R_____________________________R*
_R_____S______________________________R_____________________________R*
_RRRRRRRRRRRRRRRRRRRRRRRRRRRRRRRRRRRRRR_____________________________R